28x33
1  1  1  1  1  1  1  1  1  1  1  1  1  1  1  1  1  1  1  1  1  1  1  1  1  1  1  1
1  1  1  1  1  1  1  1  1  1  1  1  1  1  1  1  1  1  1  1  1  1  1  1  1  1  1  1
1  1  1  1  1  1  1  1  1  1  1  1  1  1  1  1  1  1  1  1  1  1  1  1  1  1  1  1
1  8  0  0  0  0  0  0  0  0  0  0  0  1  1  0  0  0  0  0  0  0  0  0  0  0  8  1
1  0  1  1  1  1  0  1  1  1  1  1  0  1  1  0  1  1  1  1  1  0  1  1  1  1  0  1
1  0  1  1  1  1  0  1  1  1  1  1  0  1  1  0  1  1  1  1  1  0  1  1  1  1  0  1
1  0  1  1  1  1  0  1  1  1  1  1  0  1  1  0  1  1  1  1  1  0  1  1  1  1  0  1
1  0  0  0  0  0  0  0  0  0  0  0  0  0  0  0  0  0  0  8  0  0  0  0  0  0  0  1
1  0  1  1  1  1  0  1  1  0  1  1  1  1  1  1  1  1  0  1  1  0  1  1  1  1  0  1
1  0  1  1  1  1  0  1  1  0  1  1  1  1  1  1  1  1  0  1  1  0  1  1  1  1  0  1
1  0  0  8  0  0  0  1  1  0  0  0  0  1  1  0  0  0  0  1  1  0  0  0  0  0  0  1
1  1  1  1  1  1  0  1  1  1  1  1  0  1  1  0  1  1  1  1  1  0  1  1  1  1  1  1
1  1  1  1  1  1  0  1  1  1  1  1  0  1  1  0  1  1  1  1  1  0  1  1  1  1  1  1
1  1  1  1  1  1  0  1  1  8  0  0  0  0  0  0  0  0  8  1  1  0  1  1  1  1  1  1
1  1  1  1  1  1  0  1  1  0  1  1  1  1  1  1  1  1  0  1  1  0  1  1  1  1  1  1
1  1  1  1  1  1  0  1  1  0  1  1  1  1  1  1  1  1  0  1  1  0  1  1  1  1  1  1
64 0  0  0  4  0  0  0  0  0  1  1  1  1  1  1  1  1  0  0  0  0  0  0  0  0  0 48
1  1  1  1  1  1  0  1  1  0  1  1  1  1  1  1  1  1  0  1  1  0  1  1  1  1  1  1
1  1  1  1  1  1  0  1  1  0  1  1  1  1  1  1  1  1  0  1  1  0  1  1  1  1  1  1
1  1  1  1  1  1  0  1  1  8  0  0  0  0  0  0  0  0  8  1  1  0  1  1  1  1  1  1
1  1  1  1  1  1  0  1  1  0  1  1  1  1  1  1  1  1  0  1  1  0  1  1  1  1  1  1
1  1  1  1  1  1  0  1  1  0  1  1  1  1  1  1  1  1  0  1  1  0  1  1  1  1  1  1
1  0  0  0  0  0  0  0  0  0  0  0  0  1  1  0  0  0  0  0  0  0  0  0  0  0  0  1
1  0  1  1  1  1  0  1  1  1  1  1  0  1  1  0  1  1  1  1  1  0  1  1  1  1  0  1
1  0  1  1  1  1  0  1  1  1  1  1  0  1  1  0  1  1  1  1  1  0  1  1  1  1  0  1
1  0  0  0  1  1  0  0  0  0  0  0  0  0  0  0  0  0  0  0  0  0  1  1  0  0  0  1
1  1  1  0  1  1  0  1  1  0  1  1  1  1  1  1  1  1  0  1  1  0  1  1  0  1  1  1
1  1  1  0  1  1  0  1  1  0  1  1  1  1  1  1  1  1  0  1  1  0  1  1  0  1  1  1
1  0  0  0  0  0  0  1  1  0  0  0  0  1  1  0  0  0  0  1  1  0  0  0  0  0  0  1
1  0  1  1  1  1  1  1  1  1  1  1  0  1  1  0  1  1  1  1  1  1  1  1  1  1  0  1
1  0  1  1  1  1  1  1  1  1  1  1  0  1  1  0  1  1  1  1  1  1  1  1  1  1  0  1
1  8  0  0  0  0  0  0  0  0  0  0  0  0  0  0  0  0  0  0  0  0  0  0  0  0  8  1
1  1  1  1  1  1  1  1  1  1  1  1  1  1  1  1  1  1  1  1  1  1  1  1  1  1  1  1
