28x33
1   1   1   1   1   1   1   1   1   1   1   1   1   1   1   1   1   1   1   1   1   1   1   1   1   1   1   1
1   1   1   1   1   1   1   1   1   1   1   1   1   1   1   1   1   1   1   1   1   1   1   1   1   1   1   1
1   1   1   1   1   1   1   1   1   1   1   1   1   1   1   1   1   1   1   1   1   1   1   1   1   1   1   1
1   8   0   0   0   0   0   0   0   0   0   0   0   1   1   0   0   0   0   0   0   0   0   0   0   0   8   1
1   0   1   1   1   1   0   1   1   1   1   1   0   1   1   0   1   1   1   1   1   0   1   1   1   1   0   1
1   0   1   1   1   1   0   1   1   1   1   1   0   1   1   0   1   1   1   1   1   0   1   1   1   1   0   1
1   0   1   1   1   1   0   1   1   1   1   1   0   1   1   0   1   1   1   1   1   0   1   1   1   1   0   1
1   0   0   0   0   0   0   0   0   0   0   0   0   0   0   0   0   0   0   8   0   0   0   0   0   0   0   1
1   0   1   1   1   1   0   1   1   0   1   1   1   1   1   1   1   1   0   1   1   0   1   1   1   1   0   1
1   0   1   1   1   1   0   1   1   0   1   1   1   1   1   1   1   1   0   1   1   0   1   1   1   1   0   1
1   0   0   8   0   0   0   1   1   0   0   0   0   1   1   0   0   0   0   1   1   0   0   0   0   0   0   1
1   1   1   1   1   1   0   1   1   1   1   1   0   1   1   0   1   1   1   1   1   0   1   1   1   1   1   1
1   1   1   1   1   1   0   1   1   1   1   1   0   1   1   0   1   1   1   1   1   0   1   1   1   1   1   1
1   1   1   1   1   1   0   1   1   8   0   0   0   0   0   0   0   0   8   1   1   0   1   1   1   1   1   1
1   1   1   1   1   1   0   1   1   0   1   1   1   1   1   1   1   1   0   1   1   0   1   1   1   1   1   1
1   1   1   1   1   1   0   1   1   0   1   1   1   1   1   1   1   1   0   1   1   0   1   1   1   1   1   1
128 0   0   0   4   0   0   0   0   0   1   1   1   1   1   1   1   1   0   0   0   0   0   0   0   0   0  64
1   1   1   1   1   1   0   1   1   0   1   1   1   1   1   1   1   1   0   1   1   0   1   1   1   1   1   1
1   1   1   1   1   1   0   1   1   0   1   1   1   1   1   1   1   1   0   1   1   0   1   1   1   1   1   1
1   1   1   1   1   1   0   1   1   8   0   0   0   0   0   0   0   0   8   1   1   0   1   1   1   1   1   1
1   1   1   1   1   1   0   1   1   0   1   1   1   1   1   1   1   1   0   1   1   0   1   1   1   1   1   1
1   1   1   1   1   1   0   1   1   0   1   1   1   1   1   1   1   1   0   1   1   0   1   1   1   1   1   1
1   0   0   0   0   0   0   0   0   0   0   0   0   1   1   0   0   0   0   0   0   0   0   0   0   0   0   1
1   0   1   1   1   1   0   1   1   1   1   1   0   1   1   0   1   1   1   1   1   0   1   1   1   1   0   1
1   0   1   1   1   1   0   1   1   1   1   1   0   1   1   0   1   1   1   1   1   0   1   1   1   1   0   1
1   0   0   0   1   1   0   0   0   0   0   0   0   0   0   0   0   0   0   0   0   0   1   1   0   0   0   1
1   1   1   0   1   1   0   1   1   0   1   1   1   1   1   1   1   1   0   1   1   0   1   1   0   1   1   1
1   1   1   0   1   1   0   1   1   0   1   1   1   1   1   1   1   1   0   1   1   0   1   1   0   1   1   1
1   0   0   0   0   0   0   1   1   0   0   0   0   1   1   0   0   0   0   1   1   0   0   0   0   0   0   1
1   0   1   1   1   1   1   1   1   1   1   1   0   1   1   0   1   1   1   1   1   1   1   1   1   1   0   1
1   0   1   1   1   1   1   1   1   1   1   1   0   1   1   0   1   1   1   1   1   1   1   1   1   1   0   1
1   8   0   0   0   0   0   0   0   0   0   0   0   0   0   0   0   0   0   0   0   0   0   0   0   0   8   1
1   1   1   1   1   1   1   1   1   1   1   1   1   1   1   1   1   1   1   1   1   1   1   1   1   1   1   1
